
100
###########
#o+++4+++##
######## ##
##+++2+++##
##x########
###########
