
100
###########
#o+++4+++5#
######## ##
#1+++2+++##
##x########
###########
