
100
##########
# dd d   #
#o dd d  #
#       x#
##########
