
3
######
#o   #
#    #
#    #
#    #
#d  x#
######
