
3
#####
#o x#
#   #
 #  #
#   #
#   #
#####
