
9
#####
#o ##
## ##
#  ##
# #x#
#   #
#####
