
20
#########
#o      #
#       #
#       #
#   #####
#  x1ee##
#########
