
20
#########
#o      #
# ###   #
# #e#   #
# ###   #
#      x#
#########
