
20
#########
#o 2ese #
#  #   ##
#  ######
#   #####
#     x##
#########
