
20
#########
#o1  #  #
# x#s#  #
#1# 1   #
#e#     #
#########
