
20
#########
# 1e    #
#o #    #
#  x    #
#########
