
20
#########
#o+++>  #
#    +  #
#    x  #
#########
