r
1000
###########
#o+++++2###
######x####
###########
###########
