
20
#########
#H    Ix#
#  H   I#
#F##### #
#o#F GG #
#########
