r
1000
###########
#o+++++1###
######x####
###########
###########
