rrrl
1000
###########
#o 1+++2###
######x####
###########
###########
