
20
#########
# 1ee   #
#o #    #
#  x    #
#########
