
20
#########
#o+++   #
#    +  #
#    x  #
#########
