
20
#########
#5++5#Fe#
#j#x##e##
#+#e # ##
#o#F#e e#
#########
