
20
#########
#       #
#o fff x#
#       #
#########
