
2
#########
# ab c  #
#o     x#
#       #
#########
