
7
#########
#       #
#o     x#
#       #
#########
