
20
#########
#oF#FA#A#
#######G#
#########
######xG#
#########
