
20
#########
#oF#F##e#
# #####G#
# #######
#     xG#
#########
