
6
#####
#o>v#
##xv#
# ^<#
#####
