
2
#######
#o+++ #
##   +#
#    +#
#    x#
#######