
20
##############################
#                            #
#                            #
#      k                    x#
# o                          #
##############################
