urrdlll
1
##############################
#                            #
#                            #
# c e                        #
#xofef                       #
##############################
